------------------------------------------------------------------------------------------------------------------------------------------------------------------------------------------------------------------------
------------------------------------------------------------------------------------------------------------------------------------------------------------------------------------------------------------------------
--------------------------e---------------------------------------------------------------------------------------------------------------------------------------------------------------------------------------------
------------------------------------------------------------------------------------------------------------------------------------------------------------------------------------------------------------------------
------------------?--------------------------------------?-?-------------------------?-------------------------------------------------------????---------------------------------------------------------------##------
---------------------------------------------------------------------------------------------------------------------------------------------------------------------------------------------------------------###------
--------------------------------------------------------------------------------------------------------------------------------------------------------------------------------------------------------------####------
-------------------------------------------------------------------------------------------------------------------------------------------------------------------------------------------------------------#####------
------------------?--------------------------------------?-?-----------------------????----------------------pP--------------pP------------???BB???---------------------------------------------------------######------
--------------pP--------------------------------------------------------------------------------#------------pP--------------pP-------------------------------------------------------#--------------------#######------
--------------pP--------------------------------------------------------------------------------#------------pP--------------pP-----------------------------pP------------------------#-------------------########------
--------------pP--------------------------------------------------------------------------------#------------pP--------------pP-----------------------------pP------------------------#------------------#########------
#########################--############################################----###################################################################--#######################---###--########--###############################
