--------------------------------------------------------------------------------------------------------------------------------------------------------------------------------------
--------------------------------------------------------------------------------------------------------------------------------------------------------------------------------------
-------------------------------------------------------------e-------------------e----------------------------------------------------------------------------------------------------
-----------#BBBBB---------------------------------BBBBBBBBBBBBBB---BBBB-BBBBBBBBBBBBB----------------------------------BBBBBB-----------------------------------------------##--------
-----------#---------------------------------------------------e-----------------------------------------------------------------------------pP----------------------------###--------
-----------#---------------------------------------------------------------------------------------------------------e-----------------------pP---------------------------####--------
----------e#--e-#--------------------?-------------------------------------------ee-----#----------------------------------------------------pP--------------------------#####--------
-----------#BBBB#---?????--------pP-----------------BBBBBBBBBBB--#B--------------???????#----------------------------pP---pP------------pP--????------------------------######--------
---------------------------------pP-----------------------------##---------------------------------------------------pP---pP------------pP-----------------------------#######--------
---------------------------------pP----------------------------###---------------------------------------------------pP---pP------------pP-------------------pP-------########--------
---------------------------------pP------ee-------------------####-----------#---ee------------ee------------eee-----pP---pP------------pP------e--------e---pP----e-#########--------
##########################pP###########pP######---####################-------##########################################---##--###################---##################################
