--------------------------------------------------------------------------------------------------------------------------------------------------------------------------------------------------------
--------------------------------------------------------------------------------------------------------------------------------------------------------------------------------------------------------
--------------------------------------------------------------------------------------------------------------------------------------------------------------------------------------------------------
--------------------------------------------------------------------------------------------------------------------------------------------------------------------------------------------------------
----------------------------------------------------------------------?-------------------------------------------------------------------------------------------------------------------------##------
-----------------------------------------------------?-----------------------------------------------------------------B-----------------------------------------------------------------------###------
----------------------------------------------------------------------------------------------------------------------------------------------------------------------------------------------####------
---------------------------------------------------------------------------------------------------------------------------------------------------------------------------------------------#####------
----------------------------------------------------------------------?---------------------------------------------------------------------------------------------------------------------######------
-----------------------------------------------------#---------------------------------e--------------------------------------------------------------------------pP-----------------------#######------
-----------------------------------------------------#--------------#---#----------------------------------------------#------------------------------------------pP----------------------########------
---------e-------e-ee----e-e-------e-e----#----------#----e--ee-e---#-e-#-----------------------------e-------ee-e-----#------e------ee-e--------e--------ee-e----pP------e-ee-----ee----#########------
#########################################################################--#########################################--###--#############################################################################
