----------------------------------------------------------------------------------------------------------------------------------------------------------------------------------------------------------------
----------------------------------------------------------------------------------------------------------------------------------------------------------------------------------------------------------------
----------------------------------------------------------------------------------------------------------------------------------------------------------------------------------------------------------------
----------------------------------------------------------------------------------------------------------------e-----------------------------------------------------------------------------------------------
----------------B?B-----------------------------------------BBBBB-----BBBB?---------------------------------B---BBBBBBBBB------------?B---BB-------------BBB-------------------------------------------##-------
-------------------------pP-----------------------------------------------------------------------------pP------------------------------------------------------pP--------------------------------e---###-------
-------------------------pP----------------------------pP-----------------------pP----------------------pP------------------------------------------------------pP-----------------------------------####-------
-------------------------##----------------------pP----pP-----------------------pP----------------------pP-------------------------BB---------------------------pP----------------------------------#####-------
---BBB------pP---?---pP----------------pP---B?---pP----##------------------?----pP-------------pP------B##B------------------------------BBB---------#---BBB----##-----pP-------pP----------------pP#####-------
------------pP-------pP----------------pP--------pP----------------------pP-----pP-----pP------pP-----------------------------------------------#-pP-#-----------------pP-----pPpP----pP----------pP#####-------
------------pP-------pP-----pPpP-------pP--------pP---------pP-----pP----pP--pP-pP-----pP------pP-pP--------pP--------------pP--pP-------------##-pP-##----------------pP---pPpPpP----pP---------#pP#####-------
------------pP----e--pP-----pPpP-------pP---e----pP---------pP-----pP----pP--pP-pP--e--pP------pP-pP--------pP--------------pP--pP------------###-pP-##-e------e-------pP---pPpPpP----pP--------##pP#####-------
####################################################################################################################------############-#-########-##############################################################
