-------------------------------------------------------------------------------------------------------------------------------------------------------------------------------
-------------------------------------------------------------------------------------------------------------------------------------------------------------------------------
---------------e---------------------------------------------------------------------------------------------------------------------------------------------------------------
-------------BBBBBBBBBBB------------???????------e--BBB?BBB?BBBB----BBBBBBBBBBBB#--------------------------------------?------------------------------------------------##-----
--------------------------------------------------------------------------------#---------e----------------------------e-----------------------------------------------###-----
--------------------------------------------------------------------------------#------e-------e----------------------------------------------------------------------####-----
-----------------e--------------------------------------------------------------#----------------------------------------pP-----------e------------------------------#####-----
-------------BBBBBBBBBBB-----????---B---------------------pP------B------------?#-pP--------------------???--------------pP-------pP--pP----------------------------######-----
----------------------------------------------------------pP--------------------#-pP------------------------------c------pP---pP--pP--pP---------e-----------------#######-----
----------------------------------------------------------pP---------------pP---#-pP---------------c--------------c------pP---pP--pP--pP--------------------------########-----
------------------------------------e-e-------------------pP---------------pP---#-pP-e-------------c-ee-----------c------pP---pP--pP--pP-------------------------#########-----
########################----############--------#################----------##################---###########################---##--################----###----##################
