--------------------------------------------------------------------------------------------------------------------------------------------------------------------------------------------------------
-----------------------------------------------------------------e----------------------------------------------------------------------------------------------------------------------------e---------
----------------------------------------------------------e---------------------------------------------------------------------------------------------------------------------------------------------
------------------------------------------------------BBBBBBBBBB-------------------------------------------------------------------------------------------------------------------------------##-------
--------------------------------------------------------------------------------------------------------------------------------------------------------------------------------------------------------
--------------------------------------------------------------------------------------------------------------------------------------------------------------------------------------------------------
-------------------c--------------------------------------------------#----------------------------------------pP-------------------------------------------------------e---------------#---#-----------
-----------c-------c------------------------------------------BBBBBBBB#----------------------------------------pP----?????????-------------------------------------???????-----------#------------------
-----------c--?-c--c---B??-------------------------------#-----------------------------------------------------pP-------------------------------------#############------------------#------------------
-----------c----c--c-------------------------------------#-----------------------------------------------------pP----c------------------B------------------------------------pP------#------------------
-----------c----c--c--------------ee---------------------#-------------------e---------ee-----------ee---------pP----c-e-----c------e-------------e--------------------------pP------#--------#---------
#######################################--#######--#-#######################################################################-############-############################-pPpP---#########----#####---------
