------------------------------------------------------------------------------------------------------------------------------------------------------------------------------------------------
------------------------------------------------------------------------------------------------------------------------------------------------------------------------------------------------
------------------------------------------------------------------------------------------------------------------------------------------------------------------------------------------------
------------------------------------------------------------------------------------------------------------------------------------------------e-----------------------------------------------
--------------------------------------------------------------------------?--------?BB------------------BB?BBB?BBB--------BB?------------------B?B--B?B--------------------------------##-------
--------------------------------------------------------------------------------------------------------------------------------------------------------------------------------------###-------
--------------------------------------------------------------------------------------------------------------------------------------#---------------------------------#-----------e####-------
------------?--?----------------------------------------------------------ee-e-------------------------------e------------BBB--------##--------------------------e------#-----------#####-------
---------?-e------eBBB---------pP---------------------B--------------##########--#--------------pP------BBBBBBBBBBB----------------g###--------B?B--B?B----e---B?BBB----#----------######-------
-------------------------pP----pP-----------------pP----------------##--------#--#--------------pP--------------------------------g####------------------------e-------##--------e#######-------
-------------------------pP----pP-----------------pP-------pP------###--------#--##-------------pP--------------------------------#####---------------------------e----##--------########-------
-------------------------pP--e-pP----------e-ee---pP-e-----pP-----####--------#--##---ee----e---pP--------e----------------------######-----e------ee-e----------------##-------#########-------
######################################---#############################--------#--########################################----##########--#################################---###################
